111111111111111111111111111111
000001000000000001000000000001
101101011111100010100000000001
110001010000100100111111110001
101001000111101000000000010001
100101010100000111111010011101
101001010100010000000011000001
101001010100101110111001000001
100001000100000000000001011111
110101110101101111111001000001
101001010100101000000001001001
100101000100001011111101001011
100001010111111010000001001001
101001010001001010000000001001
100101000001101011011111111001
101001111100101011010000000001
100100001001101011011111111101
100010001010001010010000000001
100001010010111010010011111111
100010010000100010011000000001
100100010010110010010100000001
101000011010010010010001001001
100100101001010010010001001001
100100101001010011010001001001
100101100001010001010001001001
100101001001010001010001001001
100110011101011101011101001001
100010000000000101010001001001
100000100000100100010001001001
111111111111111111111111111111